%%%%%%%%%%%%%%%%%%%%%%
%                    %
% %%%%%%%%%%%%%%%%%% %
% %                % %
% % %%%%%%%%%%%%%%%% %
% %                % %
% %%%%%%%%%%%%%%%% % % 
% %                % %
% % %%%%%%%%%%%%%%%% %
% %                % %
% %%%%%%%%%%%%%%%% % %
% %                % %
% % %%%%%%%%%%%%%%%% %
% %                % %
% %%%%%%%%%%%%%%%% % %
% %                % %
% % %%%%%%%%%%%%%%%% %
%G%                 S%
%%%%%%%%%%%%%%%%%%%%%%